20 10
###################
#.................#
#.................#
#.......#####.....#
#.......#...#.....#
#...........#.....#
#.......####......#
#.................#
#.................#
###################