20 10
###################
#.................#
#.................#
#.................#
#.......#.........#
#.................#
#.................#
#.................#
#.................#
###################