20 10
###################
#.................#
#.................#
#.................#
#.................#
#...........###...#
#.................#
#.................#
#.................#
###################