##################
#................#
#................#
#................#
#.......##.......#
#................#
#................#
#................#
##################